level1
Û°Û°Û°Û°Û°Û°Û°Û°Û°Û°Û°Û°Û°Û°Û°Û°Û°Û°Û
°                                   °
Û                                   Û
°                                   °
Û                                   Û
°                                   °
Û                                   Û
°                                   °
Û                                   Û
°                                   °
Û                                   Û
°                                   °
Û                                   Û
°                                   °
Û                                   Û
°                                   °
Û                                   Û
°                                   °
Û                                   Û
°                                   °
Û                                   Û
°                                   °
Û                                   Û
°                                   °
Û°Û°Û°Û°Û°Û°Û°Û°Û°Û°Û°Û°Û°Û°Û°Û°Û°Û°Û
end
level2
Û°Û°Û°Û°Û°Û°Û°Û°Û°Û°Û°Û°Û°Û°Û°Û°Û°Û°Û
°                                   °
Û                                   Û
°                                   °
Û                                   Û
°                                   °
Û                 Û                 Û
°                 °                 °
Û                 Û                 Û
°                 °                 °
Û                 Û                 Û
°                 °                 °
Û       Û°Û°Û°Û°Û°Û°Û°Û°Û°Û°Û       Û
°                 °                 °
Û                 Û                 Û
°                 °                 °
Û                 Û                 Û
°                 °                 °
Û                 Û                 Û
°                                   °
Û                                   Û
°                                   °
Û                                   Û
°                                   °
Û°Û°Û°Û°Û°Û°Û°Û°Û°Û°Û°Û°Û°Û°Û°Û°Û°Û°Û
end
level3
Û°Û°Û°Û°Û°Û°Û°Û°Û°Û°Û°Û°Û°Û°Û°Û°Û°Û°Û
°                                   °
Û                                   Û
°                                   °
Û                                   Û
°                                   °
Û        Û°Û°Û°Û°Û°Û°Û°Û°Û°Û°Û      Û
°                                   °
Û                                   Û
°                                   °
Û                                   Û
°                                   °
Û                                   Û
°                                   °
Û                                   Û
°                                   °
Û                                   Û
°                                   °
Û        Û°Û°Û°Û°Û°Û°Û°Û°Û°Û°Û      Û
°                                   °
Û                                   Û
°                                   °
Û                                   Û
°                                   °
Û°Û°Û°Û°Û°Û°Û°Û°Û°Û°Û°Û°Û°Û°Û°Û°Û°Û°Û
end
level4
Û°Û°Û°Û°Û°Û°Û°Û°Û°Û°Û°Û°Û°Û°Û°Û°Û°Û°Û
°                                   °
Û                                   Û
°                                   °
Û             Û       Û             Û
°             °       °             °
Û             Û       Û             Û
°             °       °             °
Û             Û       Û             Û
°             °       °             °
Û     Û°Û°Û°Û°Û       Û°Û°Û°Û°Û     Û
°                                   °
Û                                   Û
°                                   °
Û     Û°Û°Û°Û°Û       Û°Û°Û°Û°Û     Û
°             °       °             °
Û             Û       Û             Û
°             °       °             °
Û             Û       Û             Û
°             °       °             °
Û             Û       Û             Û
°                                   °
Û                                   Û
°                                   °
Û°Û°Û°Û°Û°Û°Û°Û°Û°Û°Û°Û°Û°Û°Û°Û°Û°Û°Û
end
level5
Û°Û°Û°Û°Û°Û°Û°Û°Û°Û°Û°Û°Û°Û°Û°Û°Û°Û°Û
°                                   °
Û                                   Û
°                                   °
Û  Û°Û°Û      Û       Û      Û°Û°Û  Û
°  °          °       °          °  °
Û  Û          Û       Û          Û  Û
°  °          °       °          °  °
Û  Û          Û       Û          Û  Û
°  °          °       °          °  °
Û  Û  Û°Û°Û°Û°Û       Û°Û°Û°Û°Û  Û  Û
°  °                             °  °
Û  Û                             Û  Û
°  °                             °  °
Û  Û  Û°Û°Û°Û°Û       Û°Û°Û°Û°Û  Û  Û
°  °          °       °          °  °
Û  Û          Û       Û          Û  Û
°  °          °       °          °  °
Û  Û          Û       Û          Û  Û
°  °          °       °          °  °
Û  Û°Û°Û      Û       Û      Û°Û°Û  Û
°                                   °
Û                                   Û
°                                   °
Û°Û°Û°Û°Û°Û°Û°Û°Û°Û°Û°Û°Û°Û°Û°Û°Û°Û°Û
end
